0,1,2,3,4,5,6,7
M,M,M,M,M,,,
M,M,M,M,M,,,
M,M,M,M,M,,,
M,M,M,M,M,,,
M,M,M,M,M,,,
S,L,S,L,S,,,
S,L,S,L,S,,,
S,L,S,L,S,,,
S,L,S,L,S,,,
S,L,S,L,S,,,
L,S,L,S,L,,,
L,S,L,S,L,,,
L,S,L,S,L,,,
L,S,L,S,L,,,
L,S,L,S,L,,,
L,L,L,L,L,,,
L,L,L,L,L,,,
L,L,L,L,L,,,
L,L,L,L,L,,,
L,L,L,L,L,,,
