0,1,2,3,4,5,6,7
M,S,M,S,M,,,
M,S,M,S,M,,,
M,S,M,S,M,,,
M,S,M,S,M,,,
M,S,M,S,M,,,
S,L,S,L,S,,,
S,L,S,L,S,,,
S,L,S,L,S,,,
S,L,S,L,S,,,
S,L,S,L,S,,,
L,S,L,S,L,,,
L,S,L,S,L,,,
L,S,L,S,L,,,
L,S,L,S,L,,,
L,S,L,S,L,,,
