0,1,2,3,4,5,6,7,8
S,M,S,M,S,S,S,S,S
S,M,S,M,S,,,,
S,M,S,M,S,,,,
S,M,S,M,S,,,,
S,M,S,M,S,,,,
M,S,M,S,M,,,,
M,S,M,S,M,,,,
M,S,M,S,M,,,,
M,S,M,S,M,,,,
M,S,M,S,M,,,,
S,L,S,L,S,,,,
S,L,S,L,S,,,,
S,L,S,L,S,,,,
S,L,S,L,S,,,,
S,L,S,L,S,,,,
